several	kilka
of	z
binary	binarne
been	byly
article	artykul
advanced	zaawansowane
appropriate	wlasciwy
basic	zwykly
have	ma
computer	komputer
deals	oferty
in	w
making	robia
more	wiecej
search	szukac
science	nauka
primarily	glownie
references	odwoluje
variants	warianty
the	'the'
studied	studiuja
tree	drzewo
this	to
to	do
type	typ
types	typy
with	z
when	kiedy